###################################################################################
##               ########### ############                         ############# ###
#  ##################        #######      ######## ##############                  
# ################### ############## ############  ################################
#   ###############   ############## ##########   #############                    
### ############### ################ ########## ################################## 
#   ##########              ########B##########                             ####   
# ############ ############################################################      ##
A ########         ########################################                 #######
 ################# ######################################## #######################
 ############      ########################################              ##########
 ############ ########################################################## ##########

###################################################################################