#################################################B
# ### ######### #######################
      ### ####  ####################### ##########
 #### ##  #     ###########             ######   
 #### ##  # ############### #############
 #### ##  #  #  ########### ###################
A####  #  ##### ###########      ############
 ##       #####    ############# ################
     ####                        ################